BBBBBBBBBBB
B_________B
B_P_____L_B
B_________B
BBBBBBBBBBB