BBBBBBBBBBBBBBBBBBBBBBB
B_____________________B
B___________________L_B
B_____________________B
B_________BBBBBBBBBBBBB
B_________B
B_P_______B
B_________B
BBBBBBBBBBB