BBBBBBBBBBB
B_________B
B_P_______B
B_______L_B
BBBBBBBBBBB