WWWWWWWWWWW
W_________W
W_T_____P_W
W_________W
WWWWWWWWWWW