______________________BBBBBBBBB
______________________B_______B
BBBBBBBBBBBBBBBBBBBBBBB___I___B
B__________E_________E________B
B_____________________________B
B_____________________________B
B_____________________________B
B_______________E_____________B
B_________BBBBBBBBBBBBBBBBBBBBB
B_________B
B_P_______B
B_________B
BBBBBBBBBBB