WWWWWWWWW
W_______W
W___R___WWWWWWWWWWWWWWWWWWWWWWW
W_____________________________W
W_____________________________W
W_____________________________W
WWWWWWWWWWWWWWWWWWWWW_________W
____________________W_________W
____________________W_______P_W
____________________W_________W
____________________WWWWWWWWWWW