WWWWWWWWWWWWWWWWWWWWWW
W____________________W
W_T__________________W
W____________________W
WWWWWWWWWWWWW________W
____________W________W
____________W______P_W
____________W________W
____________WWWWWWWWWW