WWWWWWWWWWW
W_________W
W_______P_W
W_T_______W
WWWWWWWWWWW