BBBBBBBBBBB
B_________B
B_P_______B
B_______R_B
BBBBBBBBBBB