BBBBBBBBBBB
B_________B
B_P_______B
B_______I_B
BBBBBBBBBBB